rdbreak	rd.break
rd_CCW	rd.ccw
rd_DASD_MOD	rd.dasd
rd_DASD	rd.dasd
rdnetdebug	rd.debug
rdinitdebug	rd.debug
rd_NO_DM	rd.dm=0
rd_DM_UUID	rd.dm.uuid
rdblacklist	rd.driver.blacklist
rdinsmodpost	rd.driver.post
rdloaddriver	rd.driver.pre
rd_NO_FSTAB	rd.fstab=0
rdinfo	rd.info
check	rd.live.check
rdlivedebug	rd.live.debug
live_dir	rd.live.dir
liveimg	rd.live.image
overlay	rd.live.overlay
readonly_overlay	rd.live.overlay.readonly
reset_overlay	rd.live.overlay.reset
live_ram	rd.live.ram
rd_NO_CRYPTTAB	rd.luks.crypttab=0
rd_LUKS_KEYDEV_UUID	rd.luks.keydev.uuid
rd_LUKS_KEYPATH	rd.luks.keypath
rd_NO_LUKS	rd.luks=0
rd_LUKS_UUID	rd.luks.uuid
rd_NO_LVMCONF	rd.lvm.conf
rd_LVM_LV	rd.lvm.lv
rd_NO_LVM	rd.lvm=0
rd_LVM_SNAPSHOT	rd.lvm.snapshot
rd_LVM_SNAPSIZE	rd.lvm.snapsize
rd_LVM_VG	rd.lvm.vg
rd_NO_MDADMCONF	rd.md.conf=0
rd_NO_MDIMSM	rd.md.imsm=0
rd_NO_MD	rd.md=0
rd_MD_UUID	rd.md.uuid
rd_NO_MULTIPATH rd.multipath=0
rd_NFS_DOMAIN	rd.nfs.domain
iscsi_initiator	rd.iscsi.initiator
iscsi_target_name	rd.iscsi.target.name
iscsi_target_ip	rd.iscsi.target.ip
iscsi_target_port	rd.iscsi.target.port
iscsi_target_group	rd.iscsi.target.group
iscsi_username	rd.iscsi.username
iscsi_password	rd.iscsi.password
iscsi_in_username	rd.iscsi.in.username
iscsi_in_password	rd.iscsi.in.password
iscsi_firmware	rd.iscsi.firmware=0
rd_NO_PLYMOUTH	rd.plymouth=0
rd_retry	rd.retry
rdshell	rd.shell
rd_NO_SPLASH	rd.splash
rdudevdebug	rd.udev.debug
rdudevinfo	rd.udev.info
rd_NO_ZFCPCONF	rd.zfcp.conf=0
rd_ZFCP	rd.zfcp
rd_ZNET	rd.znet
KEYMAP	vconsole.keymap
KEYTABLE	vconsole.keymap
SYSFONT	vconsole.font
CONTRANS	vconsole.font.map
UNIMAP	vconsole.font.unimap
UNICODE	vconsole.unicode
